xxxxxxxxxxxxx
xc         cx
x xx xxx xx x
x x   c   x x
x x xxxxx x x
x c xd e  x x
x x     x   x
x x xxxxx x x
x x       x x
x xxx x xxd x
xc    c    cx
xxxxxxxxxxxxx
